NO textures/level2_1.xpm
SO textures/level2_1.xpm
EA textures/level2_2.xpm
WE textures/level2_2.xpm 
F 156,155,176
C 0,0,0


111111111111111111111111111111
100100000000000000000000000001
101001000000011111110000000001
1100000000000000W0010000000001
110111000000000000000000000001
100111111111111111111111111111
1011
1111