NO textures/nightclub.xpm
SO textures/nightclub.xpm
EA textures/nightclub.xpm
WE textures/nightclub.xpm
F 0,51,102
C 0,0,0

111111111111111111111111111111
1000000000000000000000000000W1
101111111111111111111111111111
101
101      1111111111111
1011111110000000000001
10000000D0000000000001
1111111110000000000001
        11111111111111