NO textures/wall_texture1.xpm
SO textures/wall_texture2.xpm
WE textures/wall_texture3.xpm
EA textures/wall_texture.xpm
F 153,76,0
C 204,229,255

1111
1101
1000
1111
             11111111
             1100N001
             11000001
             11111111
    1111111
    1000001
    1000001
    1111111
