NO textures/wall_texture1.xpm
SO textures/wall_texture2.xpm
WE textures/wall_texture3.xpm
EA textures/wall_texture.xpm
F 153,76,0
C 204,229,255
111111
111111
