NO textures/wall_texture1.xpm
SO textures/wall_texture2.xpm
WE textures/wall_texture3.xpm
EA textures/wall_texture.xpm
F 153,76,0
C 204,229,255
        1111111111111111111111111
        10000000001100000000W0001
        1011000001110000000010001
        1001000000000000000000001
111111111011000001110000000000001
100000000011000001110111111111111
11110111111111011100000010001
11110111111111011101010010001
11000000110101011100000010001
100000000000000001100000010001
100N0000000000001101010010001
1100000111010101111101111010111
11110111 1110101 101111010001
11111111 1111111 111111111111
