NO ./maps/no.xpm
SO ./maps/so.xpm
WE ./maps/we.xpm
EA ./maps/ea.xpm

F 220,100,0
C 220,230,0

1111111111
10011111                                 1
111    111111111111111 111              101
1111   11100011111111 1111              11011
110011     1111                          1111
111111