NO ./images/test/no.xpm
SO ./images/test/so.xpm
WE ./images/test/we.xpm
EA ./images/test/ea.xpm

F 220,100,0
C 220,230,0

        1111111111111111111111111
        100D000000110000000000001
        1011000001110000000000001
        10010000000D0000000000001
111111111011000001110000000000001
100000000011000001D1111111D111111
1111D111111111D111000000D000111
1111D111111111011111D1111000D011
1100000011010101110000001000111
10000000000000000D000000010001
100000000000000111101001100111
11D00001101101011111111110S0111
11110111 111110101   111010001
11111111 1111111111111111111111


