NO ./images/bw/no.xpm
SO ./images/bw/so.xpm
WE ./images/bw/we.xpm
EA ./images/bw/ea.xpm

DF ./images/bw/df.xpm
DS ./images/bw/ds.xpm

S0 ./images/bw/s0.xpm
S1 ./images/bw/s1.xpm
S2 ./images/bw/s2.xpm
S3 ./images/bw/s3.xpm

F 255,255,255
C 0,0,0

1111111111111111111111111
1111111000D000D0001111111
1111110001100011000111111
1111000111100011110001111
1111000111100011110001111
1110001111100011111000111
1110001111100011111000111
1100011111100011111100011
1100011111100011111100011
1000111111100011111110001
1000D00000D000D00000D0001
1000111111100011111110001
1100011111100011111100011
1100011111100011111100011
1110001111100011111000111
1110001111100011111000111
1111000111100011110001111
1111000111100011110001111
1111110001100011000111111
1111111000D0N0D0001111111
1111111111111111111111111
