NO ./images/wolf/mossy.xpm
SO ./images/wolf/red_brick.xpm
WE ./images/wolf/color_stone.xpm
EA ./images/wolf/grey_stone.xpm

C 128,128,128
F 200,200,200

DF ./images/wolf/eagle.xpm
DS ./images/wolf/wood.xpm

S0 ./images/wolf/purple_stone.xpm
S1 ./images/wolf/blue_stone.xpm
S2 ./images/wolf/grey_stone.xpm
S3 ./images/wolf/mossy.xpm

        1111111111111111111111111
        100D000000110000000000001
        1011000001110000000000001
        10010000000D0000000000001
111111111011000001110000000000001
10000000001100000111111111D111111
1111D111111111D1110D0000D000111
1111D111111111011111D1111000D011
1100000011010101110000001000111
10000000000000000D000000010001
100000000000000111101001100111
11000001101101011111111110N0111
11110111 111110101   111010001
11111111 1111111111111111111111
