NO ./images/test/no.xpm
SO ./images/test/so.xpm
WE ./images/test/we.xpm
EA ./images/test/ea.xpm
F 220,100,0
C 220,100,0

        111111111   
      11101
111111000011111
100N0000001              
11111111111
1                               
1
1111 1111 1111
1001 1001 1111
10011100111001
10000011100001
10100000000001
11 11111001111
111111  111001
111111     111
1111111111
11  11111
11  101111
111  111
