NO ./images/test/no.xpm
SO ./images/test/so.xpm
WE ./images/test/we.xpm
EA ./images/test/ea.xpm

F 220,100,0
C 220,230,0

        1111111111111111111111111
        1000000000110000000000001
        1011000001110000000000001
        1001000000000000000000001
111111111011000001110000000000001
100000000011000001111111111111111
1111011111111101110000001000111
11110111111111011101010010001011
1100000011010101110000001000111
100000000000000001100000010001
100000000000000110101001100111
11000001101101011111111110W0111
11110111 111110101   111010001
11111111 1111111111111111111111


