NO ../cubed/images/test/no.xpm
SO ../cubed/images/test/so.xpm
WE ../cubed/images/test/we.xpm
EA ../cubed/images/test/ea.xpm

F 0,255,0
C 255,0,0

1111111111
1000000001
1010001001
1000000101
1000000101
1000001001
1000000001
1010N00001
1000000001
1111111111
