NO ./images/test/no.xpm
SO ./images/test/so.xpm
WE ./images/test/we.xpm
EA ./images/test/ea.xpm

C 0,0,0
F 255,255,255

11111111111111
100000N00111111
11111111111111