NO ./images/test/no.xpm
SO ./images/test/so.xpm
WE ./images/test/we.xpm
EA ./images/test/ea.xpm

C 0,0,0
F 255,255,255

111111
10W001
111111
